11
21
XXXXXXXXXXXXXXXXXXXXX
X....X.........X....X
X.XX.X.XXXXXXX.X.XX.X
X.X...............X.X
X.X.XX.XX...XX.XX.X.X
X......X.....X......X
X.X.XX.XXXXXXX.XX.X.X
X.X...............X.X
X.XX.X.XXXXXXX.X.XX.X
X....X.........X....X
XXXXXXXXXXXXXXXXXXXXX
