21
23
XXXXXXXXXXXXXXXXXXXXXXX
X..........X..........X
X.XXX.XXXX.X.XXXX.XXX.X
X.....................X
X.XXX.X.XXXXXXX.X.XXX.X
X.....X....X....X.....X
XXXXX.XXXX.X.XXXX.XXXXX
    X.X.........X.X    
XXXXX.X.XXX.XXX.X.XXXXX
 .......XGG.GGX....... 
XXXXX.X.XXXXXXX.X.XXXXX
    X.X.........X.X     
XXXXX.X.XXXXXXX.X.XXXXX
X..........X..........X
X.XXX.XXXX.X.XXXX.XXX.X
X...X.............X...X
XXX.X.X.XXXXXXX.X.X.XXX
X.....X....X....X.....X
X.XXXXXXXX.X.XXXXXXXX.X
X.....................X
XXXXXXXXXXXXXXXXXXXXXXX
