21
23
XXXXXXXXXXXXXXXXXXXXXXX
XOOOOOOOOOOXOOOOOOOOOOX
XOXXXOXXXXOXOXXXXOXXXOX
XOOOOOOOOOOOOOOOOOOOOOX
XOXXXOXOXXXXXXXOXOXXXOX
XOOOOOXOOOOXOOOOXOOOOOX
XXXXXOXXXXOXOXXXXOXXXXX
    XOXOOOOOOOOOXOX    
XXXXXOXOXXXOXXXOXOXXXXX
 OOOOOOOXOOOOOXOOOOOOO 
XXXXXOXOXXXXXXXOXOXXXXX
    XOXOOOOOOOOOXOX     
XXXXXOXOXXXXXXXOXOXXXXX
XOOOOOOOOOOXOOOOOOOOOOX
XOXXXOXXXXOXOXXXXOXXXOX
XOOOXOOOOOOOOOOOOOXOOOX
XXXOXOXOXXXXXXXOXOXOXXX
XOOOOOXOOOOXOOOOXOOOOOX
XOXXXXXXXXOXOXXXXXXXXOX
XOOOOOOOOOOOOOOOOOOOOOX
XXXXXXXXXXXXXXXXXXXXXXX
