11
21
XXXXXXXXXXXXXXXXXXXXX
XOOOOXOOOOOOOOOXOOOOX
XOXXOXOXXXXXXXOXOXXOX
XOXOOOOOOOOOOOOOOOXOX
XOXOXXOXXOOOXXOXXOXOX
XOOOOOOXOOOOOXOOOOOOX
XOXOXXOXXXXXXXOXXOXOX
XOXOOOOOOOOOOOOOOOXOX
XOXXOXOXXXXXXXOXOXXOX
XOOOOXOOOOOOOOOXOOOOX
XXXXXXXXXXXXXXXXXXXXX
